G G G T T T T T T G G G G G G T T T T G G 
G G G T T T T T T G G G G G G T T T T G G
G G G T T T T T T G G G G G G T T T T G G
G G G G G G G G G G G G G G G G G G G G G
G G G G G G G G G G C G G G G G G G G G G
G G G G G G G G G G G G G G G G G G G G G
G G G G G G G G G G G G G G G G G G G G G
G G G G G G G G G G G G G G G G G G G G G
G G G G G G G G G G G G G G G G G C G G G
G G G G G G G G G G G G G G G G G G G G G
G G G G G G G G G G G G G G G G G G G G G
G G G G G G G G G G G G G G G G G G G G G
T T T T T T T T T T T T G G G T T T T T T
T T T T T T T T T T T T G G G T T T T T T
T T T T T T T T T T T T G G G T T T T T T
